Date,Time_Hour,bike_stands,Available_Bikes,Available_Bike_Stands,Avail_Bike_Changes,Avail_Bikes_Decrease,Avail_Bikes_Increase,Avail_Bike_Stand_Changes,Avail_Stands_Decrease,Avail_Stands_Increase,address,banking,Elevation,Latitude,Longitude,number,Availability,Date_Time,rain,temp,wetb,dewpt,vappr,rhum,msl,Total_Activity,Weight,Total_System_Bikes,DayofWeek,DayWeek_proc,Avg_Avail_Bikes,Avg_Avail_Bike_Change,old_index,demand,newindex,cluster
2019-03-20,1960-01-01 17:00:00,20,0,20,6,3,9,-6,9,3,Blessington Street,1,19,53.356769,-6.26814,2,0,2019-03-20 17:00:00,0,15,12.8,10.9,13.1,76,1028.2,12,3.11,1017,4,Wed,2,1,134835,-2,2,0
2019-03-20,1960-01-01 17:00:00,20,0,20,4,2,6,-4,6,2,Bolton Street,0,12,53.351182,-6.269859,3,0,2019-03-20 17:00:00,0,15,12.8,10.9,13.1,76,1028.2,8,3.93,1017,4,Wed,3,1,258889,-3,3,0
2019-03-20,1960-01-01 17:00:00,20,0,20,0,3,3,0,3,3,Greek Street,0,8,53.346874,-6.272976,4,0,2019-03-20 17:00:00,0,15,12.8,10.9,13.1,76,1028.2,6,2.97,1017,4,Wed,2,0,462884,-2,4,0
2019-03-20,1960-01-01 17:00:00,40,15,25,10,1,11,-10,11,1,Charlemont Street,0,25,53.330662,-6.260177,5,0.375,2019-03-20 17:00:00,0,15,12.8,10.9,13.1,76,1028.2,12,9.66,1017,4,Wed,18,0,98500,-3,5,0
2019-03-20,1960-01-01 17:00:00,20,1,19,5,3,8,-5,8,3,Christchurch Place,0,20,53.343368,-6.27012,6,0.05,2019-03-20 17:00:00,0,15,12.8,10.9,13.1,76,1028.2,11,3.3,1017,4,Wed,2,1,29662,-1,6,0
2019-03-20,1960-01-01 17:00:00,29,10,19,-5,5,0,5,0,5,High Street,1,15,53.343565,-6.275071,7,0.3448275862,2019-03-20 17:00:00,0,15,12.8,10.9,13.1,76,1028.2,5,2.95,1017,4,Wed,8,0,86303,2,7,0
2019-03-20,1960-01-01 17:00:00,30,26,4,-9,12,3,9,3,12,Custom House Quay,0,6,53.347884,-6.248048,8,0.8666666667,2019-03-20 17:00:00,0,15,12.8,10.9,13.1,76,1028.2,15,6.2,1017,4,Wed,19,-9,154633,7,8,0
2019-03-20,1960-01-01 17:00:00,24,2,22,6,6,12,-7,12,5,Exchequer Street,0,10,53.343034,-6.263578,9,0.0833333333,2019-03-20 17:00:00,0,15,12.8,10.9,13.1,76,1028.2,18,7.33,1017,4,Wed,10,2,275134,-8,9,0
2019-03-20,1960-01-01 17:00:00,16,1,15,6,2,8,-6,8,2,Dame Street,1,17,53.344007,-6.266802,10,0.0625,2019-03-20 17:00:00,0,15,12.8,10.9,13.1,76,1028.2,10,4.34,1017,4,Wed,7,3,282505,-6,10,0
2019-03-20,1960-01-01 17:00:00,30,0,30,0,12,12,0,12,12,Earlsfort Terrace,0,17,53.334019,-6.258371,11,0,2019-03-20 17:00:00,0,15,12.8,10.9,13.1,76,1028.2,24,3.67,1017,4,Wed,1,0,81082,-1,11,0
2019-03-20,1960-01-01 17:00:00,20,1,19,4,4,8,-4,8,4,Eccles Street,0,24,53.359246,-6.269779,12,0.05,2019-03-20 17:00:00,0,15,12.8,10.9,13.1,76,1028.2,12,2.84,1017,4,Wed,3,4,168648,-2,12,0
2019-03-20,1960-01-01 17:00:00,40,29,11,-24,24,0,24,0,24,Merrion Square South,1,16,53.338614,-6.248606,113,0.725,2019-03-20 17:00:00,0,15,12.8,10.9,13.1,76,1028.2,24,2.97,1017,4,Wed,19,-10,483750,10,113,0
2019-03-20,1960-01-01 17:00:00,30,13,17,-13,15,2,13,2,15,Fitzwilliam Square West,0,20,53.336074,-6.252825,13,0.4333333333,2019-03-20 17:00:00,0,15,12.8,10.9,13.1,76,1028.2,17,3.01,1017,4,Wed,10,-7,337784,3,13,0
2019-03-20,1960-01-01 17:00:00,30,26,4,2,7,9,-2,9,7,Fownes Street Upper,0,15,53.344603,-6.263371,14,0.8666666667,2019-03-20 17:00:00,0,15,12.8,10.9,13.1,76,1028.2,16,7.18,1017,4,Wed,18,5,131364,8,14,0
2019-03-20,1960-01-01 17:00:00,16,0,16,0,3,3,0,3,3,Hardwicke Street,0,19,53.355473,-6.264423,15,0,2019-03-20 17:00:00,0,15,12.8,10.9,13.1,76,1028.2,6,2.33,1017,4,Wed,1,1,520288,-1,15,0
2019-03-20,1960-01-01 17:00:00,20,15,5,5,3,8,-5,8,3,Georges Quay,0,6,53.347508,-6.252192,16,0.75,2019-03-20 17:00:00,0,15,12.8,10.9,13.1,76,1028.2,11,3.28,1017,4,Wed,12,0,397980,3,16,0
2019-03-20,1960-01-01 17:00:00,20,4,16,-4,5,1,4,1,5,Golden Lane,0,16,53.340803,-6.267732,17,0.2,2019-03-20 17:00:00,0,15,12.8,10.9,13.1,76,1028.2,6,2.61,1017,4,Wed,2,1,114580,2,17,0
2019-03-20,1960-01-01 17:00:00,30,0,30,2,5,7,-2,7,5,Grantham Street,1,17,53.334123,-6.265436,18,0,2019-03-20 17:00:00,0,15,12.8,10.9,13.1,76,1028.2,12,5.73,1017,4,Wed,3,3,478335,-3,18,0
2019-03-20,1960-01-01 17:00:00,30,2,28,11,2,13,-11,13,2,Herbert Place,0,16,53.334432,-6.245575,19,0.0666666667,2019-03-20 17:00:00,0,15,12.8,10.9,13.1,76,1028.2,15,7.95,1017,4,Wed,3,1,446193,-1,19,0
2019-03-20,1960-01-01 17:00:00,30,17,13,13,0,13,-13,13,0,Leinster Street South,0,6,53.34218,-6.254485,21,0.5666666667,2019-03-20 17:00:00,0,15,12.8,10.9,13.1,76,1028.2,13,5.12,1017,4,Wed,19,-2,486066,-2,21,0
2019-03-20,1960-01-01 17:00:00,20,2,18,12,0,12,-12,12,0,Townsend Street,0,10,53.345922,-6.254614,22,0.1,2019-03-20 17:00:00,0,15,12.8,10.9,13.1,76,1028.2,12,4.74,1017,4,Wed,15,2,502203,-13,22,0
2019-03-20,1960-01-01 17:00:00,30,22,8,8,1,9,-8,9,1,Custom House,1,11,53.348279,-6.254662,23,0.7333333333,2019-03-20 17:00:00,0,15,12.8,10.9,13.1,76,1028.2,10,5.71,1017,4,Wed,26,-1,425864,-4,23,0
2019-03-20,1960-01-01 17:00:00,20,5,15,-1,7,6,1,6,7,Cathal Brugha Street,0,13,53.352149,-6.260533,24,0.25,2019-03-20 17:00:00,0,15,12.8,10.9,13.1,76,1028.2,13,5.46,1017,4,Wed,11,2,299936,-6,24,0
2019-03-20,1960-01-01 17:00:00,40,0,40,0,0,0,0,0,0,Wilton Terrace (Park),1,18,53.333653,-6.248345,114,0,2019-03-20 17:00:00,0,15,12.8,10.9,13.1,76,1028.2,0,5.18,1017,4,Wed,1,0,426435,-1,114,0
2019-03-20,1960-01-01 17:00:00,30,2,28,-1,3,2,1,2,3,Merrion Square East,0,12,53.339434,-6.246548,25,0.0666666667,2019-03-20 17:00:00,0,15,12.8,10.9,13.1,76,1028.2,5,3.45,1017,4,Wed,6,-4,467916,-4,25,0
2019-03-20,1960-01-01 17:00:00,20,20,0,0,4,4,0,4,4,Merrion Square West,1,11,53.339764,-6.251988,26,1,2019-03-20 17:00:00,0,15,12.8,10.9,13.1,76,1028.2,8,3.61,1017,4,Wed,15,-4,450768,5,26,0
2019-03-20,1960-01-01 17:00:00,20,9,11,-7,9,2,7,2,9,Molesworth Street,0,18,53.341288,-6.258117,27,0.45,2019-03-20 17:00:00,0,15,12.8,10.9,13.1,76,1028.2,11,4,1017,4,Wed,5,-3,209322,4,27,0
2019-03-20,1960-01-01 17:00:00,30,0,30,6,0,6,-6,6,0,Mountjoy Square West,0,18,53.356299,-6.258586,28,0,2019-03-20 17:00:00,0,15,12.8,10.9,13.1,76,1028.2,6,5.77,1017,4,Wed,3,3,83131,-3,28,0
2019-03-20,1960-01-01 17:00:00,29,0,29,1,8,9,-1,9,8,Ormond Quay Upper,1,8,53.346057,-6.268001,29,0,2019-03-20 17:00:00,0,15,12.8,10.9,13.1,76,1028.2,17,5.04,1017,4,Wed,7,0,115987,-7,29,0
2019-03-20,1960-01-01 17:00:00,20,0,20,0,1,1,0,1,1,Parnell Square North,1,15,53.353462,-6.265305,30,0,2019-03-20 17:00:00,0,15,12.8,10.9,13.1,76,1028.2,2,2.2,1017,4,Wed,2,0,366937,-2,30,0
2019-03-20,1960-01-01 17:00:00,20,0,20,6,5,11,-6,11,5,Parnell Street,0,11,53.350929,-6.265125,31,0,2019-03-20 17:00:00,0,15,12.8,10.9,13.1,76,1028.2,16,5.72,1017,4,Wed,6,-1,139882,-6,31,0
2019-03-20,1960-01-01 17:00:00,30,22,8,7,1,8,-7,8,1,Pearse Street,1,8,53.344304,-6.250427,32,0.7333333333,2019-03-20 17:00:00,0,15,12.8,10.9,13.1,76,1028.2,9,6.55,1017,4,Wed,23,0,476088,-1,32,0
2019-03-20,1960-01-01 17:00:00,23,9,14,7,3,10,-7,10,3,Princes Street / O'Connell Street,1,13,53.349013,-6.260311,33,0.3913043478,2019-03-20 17:00:00,0,15,12.8,10.9,13.1,76,1028.2,13,7.02,1017,4,Wed,18,0,394294,-9,33,0
2019-03-20,1960-01-01 17:00:00,30,27,3,3,13,16,-3,16,13,Portobello Harbour,0,24,53.330362,-6.265163,34,0.9,2019-03-20 17:00:00,0,15,12.8,10.9,13.1,76,1028.2,29,8.95,1017,4,Wed,17,4,140685,10,34,0
2019-03-20,1960-01-01 17:00:00,30,0,30,7,2,9,-7,9,2,Smithfield,0,9,53.347692,-6.278214,35,0,2019-03-20 17:00:00,0,15,12.8,10.9,13.1,76,1028.2,11,4.83,1017,4,Wed,3,3,542172,-3,35,0
2019-03-20,1960-01-01 17:00:00,30,8,22,8,1,9,-8,9,1,Killarney Street,0,5,53.354845,-6.247579,115,0.2666666667,2019-03-20 17:00:00,0,15,12.8,10.9,13.1,76,1028.2,10,4.84,1017,4,Wed,13,7,481832,-5,115,0
2019-03-20,1960-01-01 17:00:00,40,19,20,-19,19,0,20,0,20,St. Stephen's Green East,1,16,53.337824,-6.256035,36,0.475,2019-03-20 17:00:00,0,15,12.8,10.9,13.1,76,1028.2,19,4.91,1017,4,Wed,11,-8,192530,8,36,0
2019-03-20,1960-01-01 17:00:00,30,0,30,0,1,1,0,1,1,St. Stephen's Green South,1,17,53.337494,-6.26199,37,0,2019-03-20 17:00:00,0,15,12.8,10.9,13.1,76,1028.2,2,2.97,1017,4,Wed,3,0,28866,-3,37,0
2019-03-20,1960-01-01 17:00:00,40,17,23,-2,6,4,2,4,6,Talbot Street,0,7,53.350974,-6.25294,38,0.425,2019-03-20 17:00:00,0,15,12.8,10.9,13.1,76,1028.2,10,6.48,1017,4,Wed,23,0,114942,-6,38,0
2019-03-20,1960-01-01 17:00:00,20,8,12,-8,10,2,8,2,10,Wilton Terrace,1,17,53.332383,-6.252717,39,0.4,2019-03-20 17:00:00,0,15,12.8,10.9,13.1,76,1028.2,12,4.96,1017,4,Wed,3,-1,39577,5,39,0
2019-03-20,1960-01-01 17:00:00,21,2,19,0,3,3,0,3,3,Jervis Street,1,17,53.3483,-6.266651,40,0.0952380952,2019-03-20 17:00:00,0,15,12.8,10.9,13.1,76,1028.2,6,4.76,1017,4,Wed,6,-1,455743,-4,40,0
2019-03-20,1960-01-01 17:00:00,20,0,20,1,2,3,-1,3,2,Harcourt Terrace,0,18,53.332763,-6.257942,41,0,2019-03-20 17:00:00,0,15,12.8,10.9,13.1,76,1028.2,5,2.84,1017,4,Wed,2,-1,524498,-2,41,0
2019-03-20,1960-01-01 17:00:00,30,6,24,6,2,8,-6,8,2,Smithfield North,1,9,53.349562,-6.278198,42,0.2,2019-03-20 17:00:00,0,15,12.8,10.9,13.1,76,1028.2,10,5.06,1017,4,Wed,13,6,493369,-7,42,0
2019-03-20,1960-01-01 17:00:00,30,12,18,18,2,20,-18,20,2,Portobello Road,1,21,53.330091,-6.268044,43,0.4,2019-03-20 17:00:00,0,15,12.8,10.9,13.1,76,1028.2,22,5.83,1017,4,Wed,14,7,397084,-2,43,0
2019-03-20,1960-01-01 17:00:00,30,3,27,6,3,9,-6,9,3,Upper Sherrard Street,0,15,53.358437,-6.260641,44,0.1,2019-03-20 17:00:00,0,15,12.8,10.9,13.1,76,1028.2,12,4.02,1017,4,Wed,8,9,47788,-5,44,0
2019-03-20,1960-01-01 17:00:00,30,9,21,2,1,3,-2,3,1,Deverell Place,0,6,53.351464,-6.255265,45,0.3,2019-03-20 17:00:00,0,15,12.8,10.9,13.1,76,1028.2,4,2.7,1017,4,Wed,12,4,430637,-3,45,0
2019-03-20,1960-01-01 17:00:00,20,5,15,4,4,8,-4,8,4,Strand Street Great,1,8,53.347082,-6.264192,46,0.25,2019-03-20 17:00:00,0,15,12.8,10.9,13.1,76,1028.2,12,3.66,1017,4,Wed,8,2,477085,-3,46,0
2019-03-20,1960-01-01 17:00:00,40,17,23,-17,17,0,17,0,17,Herbert Street,0,17,53.335742,-6.24551,47,0.425,2019-03-20 17:00:00,0,15,12.8,10.9,13.1,76,1028.2,17,3.53,1017,4,Wed,10,-8,256206,7,47,0
2019-03-20,1960-01-01 17:00:00,40,36,4,2,2,4,-2,4,2,Excise Walk,0,14,53.347777,-6.244239,48,0.9,2019-03-20 17:00:00,0,15,12.8,10.9,13.1,76,1028.2,6,5.81,1017,4,Wed,25,-4,174840,11,48,0
2019-03-20,1960-01-01 17:00:00,40,35,5,-32,37,5,32,5,37,Guild Street,0,8,53.347932,-6.240928,49,0.875,2019-03-20 17:00:00,0,15,12.8,10.9,13.1,76,1028.2,42,6.71,1017,4,Wed,22,-11,392212,13,49,0
2019-03-20,1960-01-01 17:00:00,40,6,34,6,3,9,-6,9,3,George's Lane,0,12,53.35023,-6.279696,50,0.15,2019-03-20 17:00:00,0,15,12.8,10.9,13.1,76,1028.2,12,4.83,1017,4,Wed,9,8,301770,-3,50,0
2019-03-20,1960-01-01 17:00:00,40,0,40,3,1,4,-3,4,1,York Street West,0,15,53.339334,-6.264699,51,0,2019-03-20 17:00:00,0,15,12.8,10.9,13.1,76,1028.2,5,3.85,1017,4,Wed,9,-1,176220,-9,51,0
2019-03-20,1960-01-01 17:00:00,32,24,8,-22,22,0,22,0,22,York Street East,0,22,53.338755,-6.262003,52,0.75,2019-03-20 17:00:00,0,15,12.8,10.9,13.1,76,1028.2,22,4.85,1017,4,Wed,9,-4,32969,15,52,0
2019-03-20,1960-01-01 17:00:00,40,11,29,-11,11,0,11,0,11,Newman House,0,17,53.337132,-6.26059,53,0.275,2019-03-20 17:00:00,0,15,12.8,10.9,13.1,76,1028.2,11,3.03,1017,4,Wed,12,-9,300218,-1,53,0
2019-03-20,1960-01-01 17:00:00,33,7,26,-7,7,0,7,0,7,Clonmel Street,0,20,53.336021,-6.26298,54,0.2121212121,2019-03-20 17:00:00,0,15,12.8,10.9,13.1,76,1028.2,7,3.06,1017,4,Wed,3,-1,225139,4,54,0
2019-03-20,1960-01-01 17:00:00,36,0,36,0,0,0,0,0,0,Hatch Street,0,18,53.33403,-6.260714,55,0,2019-03-20 17:00:00,0,15,12.8,10.9,13.1,76,1028.2,0,2.91,1017,4,Wed,2,-1,548016,-2,55,0
2019-03-20,1960-01-01 17:00:00,40,4,36,-4,4,0,4,0,4,Mount Street Lower,0,20,53.33796,-6.24153,56,0.1,2019-03-20 17:00:00,0,15,12.8,10.9,13.1,76,1028.2,4,7.65,1017,4,Wed,5,2,395881,-1,56,0
2019-03-20,1960-01-01 17:00:00,23,10,13,-9,10,1,9,1,10,Grattan Street,0,9,53.339629,-6.243778,57,0.4347826087,2019-03-20 17:00:00,0,15,12.8,10.9,13.1,76,1028.2,11,2.71,1017,4,Wed,5,-3,236413,5,57,0
2019-03-20,1960-01-01 17:00:00,40,4,36,-3,4,1,3,1,4,Sir Patrick's Dun,1,11,53.339218,-6.240642,58,0.1,2019-03-20 17:00:00,0,15,12.8,10.9,13.1,76,1028.2,5,7.8,1017,4,Wed,10,-6,447238,-6,58,0
2019-03-20,1960-01-01 17:00:00,20,0,20,5,0,5,-5,5,0,Denmark Street Great,0,21,53.35561,-6.261397,59,0,2019-03-20 17:00:00,0,15,12.8,10.9,13.1,76,1028.2,5,2.21,1017,4,Wed,1,1,228825,-1,59,0
2019-03-20,1960-01-01 17:00:00,30,10,20,15,4,19,-15,19,4,North Circular Road,0,12,53.359624,-6.260348,60,0.3333333333,2019-03-20 17:00:00,0,15,12.8,10.9,13.1,76,1028.2,23,6.2,1017,4,Wed,15,7,41673,-5,60,0
2019-03-20,1960-01-01 17:00:00,25,0,25,1,2,3,-1,3,2,Hardwicke Place,1,19,53.357043,-6.263232,61,0,2019-03-20 17:00:00,0,15,12.8,10.9,13.1,76,1028.2,5,3.26,1017,4,Wed,2,2,172570,-2,61,0
2019-03-20,1960-01-01 17:00:00,40,28,12,-27,27,0,27,0,27,Lime Street,0,4,53.346026,-6.243576,62,0.7,2019-03-20 17:00:00,0,15,12.8,10.9,13.1,76,1028.2,27,4.44,1017,4,Wed,8,-6,82556,18,62,0
2019-03-20,1960-01-01 17:00:00,35,28,7,-24,24,0,24,0,24,Fenian Street,0,6,53.341428,-6.24672,63,0.8,2019-03-20 17:00:00,0,15,12.8,10.9,13.1,76,1028.2,24,4.2,1017,4,Wed,19,-8,548970,9,63,0
2019-03-20,1960-01-01 17:00:00,40,22,18,0,4,4,0,4,4,Sandwith Street,1,4,53.345203,-6.247163,64,0.55,2019-03-20 17:00:00,0,15,12.8,10.9,13.1,76,1028.2,8,5.12,1017,4,Wed,22,-4,529971,0,64,0
2019-03-20,1960-01-01 17:00:00,40,29,11,-29,30,1,29,1,30,Convention Centre,1,6,53.34744,-6.238523,65,0.725,2019-03-20 17:00:00,0,15,12.8,10.9,13.1,76,1028.2,31,4.38,1017,4,Wed,10,-8,59489,18,65,0
2019-03-20,1960-01-01 17:00:00,40,0,40,4,1,5,-4,5,1,New Central Bank,0,7,53.347122,-6.234749,66,0,2019-03-20 17:00:00,0,15,12.8,10.9,13.1,76,1028.2,6,6.49,1017,4,Wed,3,0,242119,-3,66,0
2019-03-20,1960-01-01 17:00:00,40,25,15,-10,13,3,10,3,13,The Point,0,6,53.346867,-6.230852,67,0.625,2019-03-20 17:00:00,0,15,12.8,10.9,13.1,76,1028.2,16,5.77,1017,4,Wed,18,-3,127498,7,67,0
2019-03-20,1960-01-01 17:00:00,40,11,29,-11,11,0,11,0,11,Hanover Quay,1,5,53.344115,-6.237153,68,0.275,2019-03-20 17:00:00,0,15,12.8,10.9,13.1,76,1028.2,11,7.93,1017,4,Wed,8,-5,472618,3,68,0
2019-03-20,1960-01-01 17:00:00,40,21,19,-16,20,4,16,4,20,Grand Canal Dock,0,5,53.342638,-6.238695,69,0.525,2019-03-20 17:00:00,0,15,12.8,10.9,13.1,76,1028.2,24,7.06,1017,4,Wed,11,-8,150886,10,69,0
2019-03-20,1960-01-01 17:00:00,28,19,8,-1,14,13,2,13,15,Barrow Street,1,8,53.341655,-6.236198,70,0.6785714286,2019-03-20 17:00:00,0,15,12.8,10.9,13.1,76,1028.2,27,6.31,1017,4,Wed,11,-4,42920,8,70,0
2019-03-20,1960-01-01 17:00:00,40,1,39,-1,2,1,1,1,2,Kevin Street,1,16,53.337757,-6.267699,71,0.025,2019-03-20 17:00:00,0,15,12.8,10.9,13.1,76,1028.2,3,4.5,1017,4,Wed,2,1,11084,-1,71,0
2019-03-20,1960-01-01 17:00:00,31,3,28,9,10,19,-9,19,10,John Street West,0,20,53.343105,-6.277167,72,0.0967741935,2019-03-20 17:00:00,0,15,12.8,10.9,13.1,76,1028.2,29,4.59,1017,4,Wed,8,5,215541,-5,72,0
2019-03-20,1960-01-01 17:00:00,30,2,28,-1,3,2,1,2,3,Francis Street,0,16,53.342081,-6.275233,73,0.0666666667,2019-03-20 17:00:00,0,15,12.8,10.9,13.1,76,1028.2,5,4.11,1017,4,Wed,6,1,286002,-4,73,0
2019-03-20,1960-01-01 17:00:00,30,21,9,-2,5,3,2,3,5,Oliver Bond Street,0,13,53.343893,-6.280531,74,0.7,2019-03-20 17:00:00,0,15,12.8,10.9,13.1,76,1028.2,8,3.92,1017,4,Wed,13,-1,162839,8,74,0
2019-03-20,1960-01-01 17:00:00,40,1,39,13,0,13,-13,13,0,James Street,1,19,53.343456,-6.287409,75,0.025,2019-03-20 17:00:00,0,15,12.8,10.9,13.1,76,1028.2,13,3.69,1017,4,Wed,14,7,133649,-13,75,0
2019-03-20,1960-01-01 17:00:00,38,1,37,1,2,3,-1,3,2,Market Street South,0,27,53.342296,-6.287661,76,0.0263157895,2019-03-20 17:00:00,0,15,12.8,10.9,13.1,76,1028.2,5,3.2,1017,4,Wed,12,1,11689,-11,76,0
2019-03-20,1960-01-01 17:00:00,29,2,27,0,4,4,0,4,4,Wolfe Tone Street,0,11,53.348875,-6.267459,77,0.0689655172,2019-03-20 17:00:00,0,15,12.8,10.9,13.1,76,1028.2,8,3.66,1017,4,Wed,5,0,9137,-3,77,0
2019-03-20,1960-01-01 17:00:00,40,3,37,8,0,8,-8,8,0,Mater Hospital,0,21,53.359967,-6.264828,78,0.075,2019-03-20 17:00:00,0,15,12.8,10.9,13.1,76,1028.2,8,3.97,1017,4,Wed,7,6,369454,-4,78,0
2019-03-20,1960-01-01 17:00:00,27,0,27,2,1,3,-2,3,1,Eccles Street East,0,22,53.358115,-6.265601,79,0,2019-03-20 17:00:00,0,15,12.8,10.9,13.1,76,1028.2,4,2.16,1017,4,Wed,1,1,181908,-1,79,0
2019-03-20,1960-01-01 17:00:00,40,10,30,1,4,5,-1,5,4,St James Hospital (Luas),0,22,53.341359,-6.292951,80,0.25,2019-03-20 17:00:00,0,15,12.8,10.9,13.1,76,1028.2,9,4.5,1017,4,Wed,11,7,429232,-1,80,0
2019-03-20,1960-01-01 17:00:00,40,0,40,0,0,0,0,0,0,St. James Hospital (Central),0,21,53.339983,-6.295594,81,0,2019-03-20 17:00:00,0,15,12.8,10.9,13.1,76,1028.2,0,1.78,1017,4,Wed,7,2,376032,-7,81,0
2019-03-20,1960-01-01 17:00:00,22,0,22,1,1,2,-1,2,1,Mount Brown,0,13,53.341645,-6.29719,82,0,2019-03-20 17:00:00,0,15,12.8,10.9,13.1,76,1028.2,3,1.74,1017,4,Wed,4,4,195449,-4,82,0
2019-03-20,1960-01-01 17:00:00,40,7,33,7,1,8,-7,8,1,Emmet Road,0,17,53.340714,-6.308191,83,0.175,2019-03-20 17:00:00,0,15,12.8,10.9,13.1,76,1028.2,9,3.75,1017,4,Wed,12,9,50103,-5,83,0
2019-03-20,1960-01-01 17:00:00,30,5,25,2,1,3,-2,3,1,Brookfield Road,0,20,53.339005,-6.300217,84,0.1666666667,2019-03-20 17:00:00,0,15,12.8,10.9,13.1,76,1028.2,4,2.96,1017,4,Wed,7,6,243697,-2,84,0
2019-03-20,1960-01-01 17:00:00,35,6,29,9,2,11,-9,11,2,Rothe Abbey,1,23,53.338776,-6.30395,85,0.1714285714,2019-03-20 17:00:00,0,15,12.8,10.9,13.1,76,1028.2,13,3.38,1017,4,Wed,10,6,205893,-4,85,0
2019-03-20,1960-01-01 17:00:00,38,12,26,16,2,18,-16,18,2,Parkgate Street,1,10,53.347972,-6.291804,86,0.3157894737,2019-03-20 17:00:00,0,15,12.8,10.9,13.1,76,1028.2,20,4.34,1017,4,Wed,21,9,370418,-9,86,0
2019-03-20,1960-01-01 17:00:00,38,1,37,3,1,4,-3,4,1,Collins Barracks Museum,1,8,53.347477,-6.28525,87,0.0263157895,2019-03-20 17:00:00,0,15,12.8,10.9,13.1,76,1028.2,5,2.98,1017,4,Wed,6,7,125002,-5,87,0
2019-03-20,1960-01-01 17:00:00,30,9,21,5,4,9,-5,9,4,Blackhall Place,0,11,53.3488,-6.281637,88,0.3,2019-03-20 17:00:00,0,15,12.8,10.9,13.1,76,1028.2,13,3.65,1017,4,Wed,8,6,270099,1,88,0
2019-03-20,1960-01-01 17:00:00,40,7,33,-7,7,0,7,0,7,Fitzwilliam Square East,1,18,53.335211,-6.2509,89,0.175,2019-03-20 17:00:00,0,15,12.8,10.9,13.1,76,1028.2,7,3.17,1017,4,Wed,9,-6,185564,-2,89,0
2019-03-20,1960-01-01 17:00:00,40,19,21,-18,19,1,18,1,19,Benson Street,0,8,53.344153,-6.233451,90,0.475,2019-03-20 17:00:00,0,15,12.8,10.9,13.1,76,1028.2,20,4.32,1017,4,Wed,3,-3,548347,16,90,0
2019-03-20,1960-01-01 17:00:00,30,17,13,5,4,9,-5,9,4,South Dock Road,0,4,53.341833,-6.231291,91,0.5666666667,2019-03-20 17:00:00,0,15,12.8,10.9,13.1,76,1028.2,13,6.03,1017,4,Wed,12,1,35282,5,91,0
2019-03-20,1960-01-01 17:00:00,40,12,27,12,0,12,-12,12,0,Heuston Bridge (North),0,5,53.347802,-6.292432,92,0.3,2019-03-20 17:00:00,0,15,12.8,10.9,13.1,76,1028.2,12,4.23,1017,4,Wed,24,10,120308,-12,92,0
2019-03-20,1960-01-01 17:00:00,40,32,8,8,1,9,-8,9,1,Heuston Station (Central),0,5,53.346603,-6.296924,93,0.8,2019-03-20 17:00:00,0,15,12.8,10.9,13.1,76,1028.2,10,2.79,1017,4,Wed,30,8,275529,2,93,0
2019-03-20,1960-01-01 17:00:00,40,3,37,36,1,37,-36,37,1,Heuston Station (Car Park),0,5,53.346985,-6.297804,94,0.075,2019-03-20 17:00:00,0,15,12.8,10.9,13.1,76,1028.2,38,2.2,1017,4,Wed,14,13,104128,-11,94,0
2019-03-20,1960-01-01 17:00:00,40,9,31,14,0,14,-14,14,0,Royal Hospital,1,12,53.343897,-6.29706,95,0.225,2019-03-20 17:00:00,0,15,12.8,10.9,13.1,76,1028.2,14,3.63,1017,4,Wed,11,8,298617,-2,95,0
2019-03-20,1960-01-01 17:00:00,30,2,28,3,0,3,-3,3,0,Kilmainham Lane,0,15,53.341805,-6.305085,96,0.0666666667,2019-03-20 17:00:00,0,15,12.8,10.9,13.1,76,1028.2,3,1.58,1017,4,Wed,4,3,33732,-2,96,0
2019-03-20,1960-01-01 17:00:00,40,9,31,10,0,10,-10,10,0,Kilmainham Gaol,1,23,53.342113,-6.310015,97,0.225,2019-03-20 17:00:00,0,15,12.8,10.9,13.1,76,1028.2,10,3.66,1017,4,Wed,8,6,517432,1,97,0
2019-03-20,1960-01-01 17:00:00,40,20,20,-14,15,1,14,1,15,Frederick Street South,1,16,53.341515,-6.256853,98,0.5,2019-03-20 17:00:00,0,15,12.8,10.9,13.1,76,1028.2,16,2.96,1017,4,Wed,10,-4,107189,10,98,0
2019-03-20,1960-01-01 17:00:00,30,23,7,-15,15,0,15,0,15,City Quay,0,4,53.346637,-6.246154,99,0.7666666667,2019-03-20 17:00:00,0,15,12.8,10.9,13.1,76,1028.2,15,2.81,1017,4,Wed,14,-7,78406,9,99,0
2019-03-20,1960-01-01 17:00:00,25,25,0,-2,22,20,2,20,22,Heuston Bridge (South),0,3,53.347106,-6.292041,100,1,2019-03-20 17:00:00,0,15,12.8,10.9,13.1,76,1028.2,42,6.87,1017,4,Wed,21,0,313962,4,100,0
2019-03-20,1960-01-01 17:00:00,30,5,25,7,3,10,-7,10,3,King Street North,0,13,53.350291,-6.273507,101,0.1666666667,2019-03-20 17:00:00,0,15,12.8,10.9,13.1,76,1028.2,13,3.16,1017,4,Wed,5,3,10846,0,101,0
2019-03-20,1960-01-01 17:00:00,40,5,35,4,2,6,-4,6,2,Western Way,0,20,53.354929,-6.269425,102,0.125,2019-03-20 17:00:00,0,15,12.8,10.9,13.1,76,1028.2,8,2.65,1017,4,Wed,5,1,488999,0,102,0
2019-03-20,1960-01-01 17:00:00,40,0,40,2,0,2,-2,2,0,Grangegorman Lower (South),0,21,53.354663,-6.278681,103,0,2019-03-20 17:00:00,0,15,12.8,10.9,13.1,76,1028.2,2,1.54,1017,4,Wed,3,1,1248,-3,103,0
2019-03-20,1960-01-01 17:00:00,40,0,40,0,0,0,0,0,0,Grangegorman Lower (Central),1,21,53.355173,-6.278424,104,0,2019-03-20 17:00:00,0,15,12.8,10.9,13.1,76,1028.2,0,0.73,1017,4,Wed,2,1,153518,-2,104,0
2019-03-20,1960-01-01 17:00:00,36,0,36,0,1,1,0,1,1,Grangegorman Lower (North),0,23,53.355954,-6.278378,105,0,2019-03-20 17:00:00,0,15,12.8,10.9,13.1,76,1028.2,2,0.99,1017,4,Wed,3,0,325255,-3,105,0
2019-03-20,1960-01-01 17:00:00,40,3,37,2,1,3,-2,3,1,Rathdown Road,0,30,53.35893,-6.280337,106,0.075,2019-03-20 17:00:00,0,15,12.8,10.9,13.1,76,1028.2,4,2.02,1017,4,Wed,5,1,381057,-2,106,0
2019-03-20,1960-01-01 17:00:00,40,7,33,10,0,10,-10,10,0,Charleville Road,1,29,53.359157,-6.281866,107,0.175,2019-03-20 17:00:00,0,15,12.8,10.9,13.1,76,1028.2,10,3.08,1017,4,Wed,8,3,301498,-1,107,0
2019-03-20,1960-01-01 17:00:00,40,2,38,7,1,8,-7,8,1,Avondale Road,0,28,53.359405,-6.276142,108,0.05,2019-03-20 17:00:00,0,15,12.8,10.9,13.1,76,1028.2,9,2.39,1017,4,Wed,6,3,409742,-4,108,0
2019-03-20,1960-01-01 17:00:00,29,4,25,-1,2,1,1,1,2,Buckingham Street Lower,0,5,53.353331,-6.249319,109,0.1379310345,2019-03-20 17:00:00,0,15,12.8,10.9,13.1,76,1028.2,3,2.91,1017,4,Wed,6,2,40209,-2,109,0
2019-03-20,1960-01-01 17:00:00,40,3,37,2,1,3,-2,3,1,Phibsborough Road,0,24,53.356307,-6.273717,110,0.075,2019-03-20 17:00:00,0,15,12.8,10.9,13.1,76,1028.2,4,2.43,1017,4,Wed,5,2,498749,-2,110,0
2019-03-20,1960-01-01 17:00:00,40,5,35,-4,7,3,4,3,7,Mountjoy Square East,1,18,53.356717,-6.256359,111,0.125,2019-03-20 17:00:00,0,15,12.8,10.9,13.1,76,1028.2,10,4.93,1017,4,Wed,4,2,329785,1,111,0
2019-03-20,1960-01-01 17:00:00,30,5,25,3,3,6,-3,6,3,North Circular Road (O'Connell's),0,14,53.357841,-6.251557,112,0.1666666667,2019-03-20 17:00:00,0,15,12.8,10.9,13.1,76,1028.2,9,4.89,1017,4,Wed,10,5,331676,-5,112,0
